..................................
..................................
..................................
..................................
..................................
..................................
.........#######..................
.........#.....#..................
.........#..@..#..................
.........#.....#..................
.........##...##..................
..........#...#...................
..........#...#...................
..........#...#...................
..........#...###########.........
..........#.............!.........
..........#.............!.........
..........###############.........
..................................
..................................
..................................
..................................
..................................
..................................