..................................
..................................
..................................
..................................
..................................
..................................
.........-______..................
.........|.....|..................
.........|..@..|..................
.........|_.,.-+..................
..........|...|...................
..........|...|...................
..........|...|...................
..........|...|...................
..........|...|__________.........
..........|.............!.........
..........|.............!.........
..........|______________.........
..................................
..................................
..................................
..................................
..................................
..................................