==================================
==================================
==================================
==================================
==================================
==================================
=========???????==================
=========?%%%%%?==================
=========?%%@%%?==================
=========?%%%%%?==================
=========??%%%??==================
==========?%%%?===================
==========?%%%?===================
==========?%%%?===================
==========?%%%???????????=========
==========?%%%%%%%%%%%%%,=========
==========?%%%%%%%%%%%%%,=========
==========???????????????=========
==================================
==================================
==================================
==================================
==================================