----------------------------------
----------------------------------
----------------------------------
----------------------------------
----------------------------------
----------------------------------
---------???????------------------
---------?%%%%%?------------------
---------?%%@%%?------------------
---------?%%%%%?------------------
---------??%%%??------------------
----------?%%%?-------------------
----------?%%%?-------------------
----------?%%%?-------------------
----------?%%%???????????---------
----------?%%%%%%%%%%%%%,---------
----------?%%%%%%%%%%%%%,---------
----------???????????????---------
----------------------------------
----------------------------------
----------------------------------
----------------------------------
----------------------------------
----------------------------------